29 135 
######################################################################################################################################
#                                                                                                                                    #
#                                                                                                                                    #
#                                                                                                                                    #
#                                                                                                                                    #
#                                                                                                                                    #
#                                                                                                                                    #
#                                                                                                                                    #
#                                                                                                                                    #
#                                                                      ##                                                            #
#                                                                                                                                    #
#                                                                                                                                    #
#                                                                                                                                    #
#                                                        ##                                                                          #
#                                                                                                                                    #
#                                                                ##                                                                  #
#                                                                                                                                    #
#                                                                                                                                    #
#                                                                                                                                    #
#                                                                                                                                    #
#                                                                                                                                    #
#                                                                                                                                    #
#                                                                                                                                    #
#                                                                                                                                    #
#                                                                                                                                    #
#                                                                                                                                    #
#                                                                                                                                    #
#                                                                                                                                    #
######################################################################################################################################